111111
1P1001
110001
1E00C1
111111
