11111111
1EC100C1
10110C11
1C010C11
110PC011
11111111
