11111111
1E01C001
1011P011
10010011
11PP0011
11111111
