11111111
1E01CE01
1011P011
10010011
11000011
11111111
