11111111
1E010001
10110011
10010011
110P0011
11111111
