111111111111111111111111111111
10000C000000000000000000000001
10000C000000000000000000000001
10000C000000000000000000000001
10000C000000000000000000000001
10000C000000000000000000000001
10000C000000000000000000000001
10000C000000000000000000000001
10000C000000000000000000000001
10000C000000000000000000000001
10000C000000000000000000000001
10000C000000000000000000000001
10000C000000000000000000000001
10000C000000000000000000000001
10000C000000000000000000000001
10000C0000P00000E0000000000001
111111111111111111111111111111
